...##.............
........$....m....
..####....#.......
..#p....$....m....
..####....#.......
........$....m....
...##.............